{
  "id": "test-armor-knight-stomp-v2",
  "name": "ARMOR KNIGHT STOMP TEST V2",
  "width": 20,
  "height": 15,
  "tileSize": 16,
  "backgroundColor": 1,
  "playerSpawn": {
    "x": 8,
    "y": 10
  },
  "goal": {
    "x": 18,
    "y": 13
  },
  "timeLimit": 600,
  "tilemap": [
    [0,0,0,0,0,0,0,0,0,0,0,0,0,0,0,0,0,0,0,0],
    [0,0,0,0,0,0,0,0,0,0,0,0,0,0,0,0,0,0,0,0],
    [0,0,0,0,0,0,0,0,0,0,0,0,0,0,0,0,0,0,0,0],
    [0,0,0,0,0,0,0,0,0,0,0,0,0,0,0,0,0,0,0,0],
    [0,0,0,0,0,0,0,0,0,0,0,0,0,0,0,0,0,0,0,0],
    [0,0,0,0,0,0,0,0,0,0,0,0,0,0,0,0,0,0,0,0],
    [0,0,0,0,0,0,0,0,0,0,0,0,0,0,0,0,0,0,0,0],
    [0,0,0,0,0,0,0,0,0,0,0,0,0,0,0,0,0,0,0,0],
    [0,0,0,0,0,0,0,0,0,0,0,0,0,0,0,0,0,0,0,0],
    [0,0,0,0,0,0,0,0,0,0,0,0,0,0,0,0,0,0,0,0],
    [0,0,0,0,0,0,0,0,0,1,1,0,0,0,0,0,0,0,0,0],
    [0,0,0,0,0,0,0,0,1,1,1,1,0,0,0,0,0,0,0,0],
    [0,0,0,0,0,0,0,0,1,0,0,1,0,0,0,0,0,0,0,0],
    [1,1,1,1,1,1,1,1,1,0,0,1,1,1,1,1,1,1,1,1],
    [1,1,1,1,1,1,1,1,1,1,1,1,1,1,1,1,1,1,1,1]
  ],
  "tileTypes": {
    "0": "empty",
    "1": "ground"
  },
  "entities": [
    {
      "type": "armor_knight",
      "x": 10,
      "y": 12
    },
    {
      "type": "goal",
      "x": 18,
      "y": 13
    }
  ]
}