{
  "id": "tutorial",
  "name": "TUTORIAL",
  "width": 20,
  "height": 15,
  "tileSize": 16,
  "backgroundColor": "#5C94FC",
  "playerSpawn": {
    "x": 3,
    "y": 11
  },
  "goal": {
    "x": 17,
    "y": 11
  },
  "timeLimit": 300,
  "tilemap": [
    [0,0,0,0,0,0,0,0,0,0,0,0,0,0,0,0,0,0,0,0],
    [0,0,0,0,0,0,0,0,0,0,0,0,0,0,0,0,0,0,0,0],
    [0,0,0,0,0,0,0,0,0,0,0,0,0,0,0,0,0,0,0,0],
    [0,0,0,0,0,0,0,0,0,0,0,0,0,0,0,0,0,0,0,0],
    [0,0,0,0,0,0,0,0,0,0,0,0,0,0,0,0,0,0,0,0],
    [0,0,0,0,0,0,0,0,0,0,0,0,0,0,0,0,0,0,0,0],
    [0,0,0,0,0,0,0,0,0,0,0,0,0,0,0,0,0,0,0,0],
    [0,0,0,0,0,0,0,0,0,0,0,0,0,0,0,0,0,0,0,0],
    [0,0,0,0,0,0,0,0,0,0,0,0,0,0,0,0,0,0,0,0],
    [0,0,0,0,0,0,0,1,1,1,0,0,0,0,0,0,0,0,0,0],
    [0,0,0,0,0,0,0,0,0,0,0,0,0,0,0,0,0,0,0,0],
    [0,0,0,0,0,1,0,0,0,0,0,1,1,0,0,0,0,0,0,0],
    [0,0,0,0,0,0,0,0,0,0,0,0,0,0,0,0,0,0,0,0],
    [1,1,1,1,1,1,1,1,1,1,1,1,1,1,1,1,1,1,1,1],
    [1,1,1,1,1,1,1,1,1,1,1,1,1,1,1,1,1,1,1,1]
  ],
  "tileTypes": {
    "0": "empty",
    "1": "ground"
  },
  "entities": [
    {
      "type": "coin",
      "x": 7,
      "y": 8
    },
    {
      "type": "coin",
      "x": 8,
      "y": 8
    },
    {
      "type": "coin",
      "x": 9,
      "y": 8
    },
    {
      "type": "coin",
      "x": 11,
      "y": 10
    },
    {
      "type": "coin",
      "x": 12,
      "y": 10
    }
  ]
}